11111111111111
100P0010000001
1E000010010001
1000C011110001
1E000000000001
11111111111111